AA/CGTT	AclI
A/AGCTT	HindIII
AAT/ATT	SspI
/AATT	MluCI
A/CATGT	PciI
A/CCGGT	AgeI
A/CCWGGT	SexAI
A/CGCGT	MluI
A/CGT	HpyCH4IV
ACN/GT	HpyCH4III
A/CRYGT	AflIII
A/CTAGT	SpeI
A/GATCT	BglII
AGC/GCT	AfeI
AG/CT	AluI
AGG/CCT	StuI
AGT/ACT	ScaI
AT/CGAT	ClaI
ATGCA/T	NsiI
AT/TAAT	AseI
ATTT/AAAT	SwaI
C/AATTG	MfeI
CAC/GTG	PmlI
CACNNN/GTG	DraIII
CACNN/NNGTG	AleI-v2
CAG/CTG	PvuII
CAGNNN/CTG	AlwNI
CA/TATG	NdeI
CATG/	NlaIII
C/ATG	CviAII
/CATG	FatI
CAYNN/NNRTG	MslI
CCANNNNN/NNNNTGG	XcmI
CCANNNNN/NTGG	BstXI
CCANNNN/NTGG	PflMI
C/CATGG	NcoI
C/CCGGG	XmaI
C/CCGGG	TspMI
CCC/GGG	SmaI
CCGC/GG	SacII
C/CGG	HpaII
C/CGG	MspI
/CCNGG	StyD4I
CC/NGG	ScrFI
C/CNNGG	BsaJI
CCNNNNN/NNGG	BslI
C/CRYGG	BtgI
CC/SGG	NciI
C/CTAGG	AvrII
CCTGCA/GG	SbfI
CC/TNAGG	Bsu36I
CCTNN/NNNAGG	EcoNI
/CCWGG	PspGI
CC/WGG	BstNI
C/CWWGG	StyI
CGAT/CG	PvuI
CG/CG	BstUI
C/GGCCG	EagI
CG/GWCCG	RsrII
CGRY/CG	BsiEI
C/GTACG	BsiWI
CGWCG/	Hpy99I
CMG/CKG	MspA1I
CNNNNNNNNNNN/NNNNNNNNNG	AbaSI
CR/CCGGYG	SgrAI
C/TAG	BfaI
C/TCGAG	XhoI
CTGCA/G	PstI
C/TNAG	DdeI
C/TRYAG	SfcI
C/TTAAG	AflII
C/TYRAG	SmlI
C/YCGRG	AvaI
GAANN/NNTTC	XmnI
G/AATTC	EcoRI
GAC/GTC	ZraI
GACGT/C	AatII
GACN/NNGTC	Tth111I
GACN/NNGTC	PflFI
GACNN/NNGTC	PshAI
GACNNN/NNGTC	AhdI
GACNNNN/NNGTC	DrdI
GAGCT/C	SacI
GAG/CTC	Eco53kI
G/ANTC	HinfI
GAT/ATC	EcoRV
/GATC	Sau3AI
/GATC	MboI
/GATC	DpnII
GA/TC	DpnI
GATNN/NNATC	BsaBI
G/AWTC	TfiI
GCANNNN/NTGC	BstAPI
GCATG/C	SphI
GCCC/GGGC	SrfI
G/CCGGC	NgoMIV
GCC/GGC	NaeI
GCCNNNN/NGGC	BglI
GCGAT/CGC	AsiSI
GCG/C	HhaI
G/CGC	HinP1I
G/CGCGC	BssHII
GC/GGCCGC	NotI
GC/NGC	Fnu4HI
GCN/NGC	Cac8I
GCNNNNN/NNGC	MwoI
GCTAG/C	BmtI
G/CTAGC	NheI
GC/TNAGC	BlpI
G/CWGC	TseI
G/CWGC	ApeKI
GDGCH/C	Bsp1286I
G/GATCC	BamHI
GG/CC	HaeIII
GGCCGG/CC	FseI
GGCCNNNN/NGGCC	SfiI
GG/CGCC	NarI
G/GCGCC	KasI
GGCGC/C	PluTI
GGC/GCC	SfoI
GG/CGCGCC	AscI
G/GGCCC	PspOMI
GGGCC/C	ApaI
G/GNCC	Sau96I
GGN/NCC	NlaIV
GGTAC/C	KpnI
G/GTACC	Acc65I
G/GTNACC	BstEII
G/GWCC	AvaII
G/GYRCC	BanI
GKGCM/C	BaeGI
GR/CGYC	BsaHI
GRGCY/C	BanII
GT/AC	RsaI
G/TAC	CviQI
G/TCGAC	SalI
G/TGCAC	ApaLI
GT/MKAC	AccI
GTN/NAC	Hpy166II
/GTSAC	Tsp45I
GTT/AAC	HpaI
GTTT/AAAC	PmeI
GTY/RAC	HincII
GWGCW/C	BsiHKAI
NNCASTGNN/	TspRI
R/AATTY	ApoI
RCATG/Y	NspI
R/CCGGY	BsrFI-v2
R/GATCY	BstYI
RGCGC/Y	HaeII
RG/CY	CviKI-1
RG/GNCCY	EcoO109I
RG/GWCCY	PpuMI
TAC/GTA	SnaBI
T/CATGA	BspHI
T/CCGGA	BspEI
T/CGA	TaqI-v2
TCG/CGA	NruI
TCN/GA	Hpy188I
TC/NNGA	Hpy188III
T/CTAGA	XbaI
T/GATCA	BclI
TG/CA	HpyCH4V
TGC/GCA	FspI
TGG/CCA	MscI
T/GTACA	BsrGI
T/TAA	MseI
TTAAT/TAA	PacI
TTA/TAA	PsiI-v2
TT/CGAA	BstBI
TTT/AAA	DraI
VC/TCGAGB	PspXI
W/CCGGW	BsaWI
YAC/GTR	BsaAI
Y/GGCCR	EaeI